TCCCCTCCCCTCCCCTCCCCTCCCCTCCCCTCCCCTCCCCTCCCCTCCCCTCCCCTCCCCTCCCCTCCCCTCCCCTCCCCTCCCCTCCCCTCCCC                              TCCCCTCCCCTCCCCTCCCCTCCCCTCCCCTCCCCTCCCCTCCCCTCCCCTCCCCTCCCCTCCCCTCCCCTCCCC
CCCCCCCCCCCCCCCCCCCCCCCCCCCCCCCCCCCCCCCCCCCCCCCCCCCCCCCCCCCCCCCCCCCCCCCCCCCCCCCCCCCCCCCCCCCCCCC                              CCCCCCCCCCCCCCCCCCCCCCCCCCCCCCCCCCCCCCCCCCCCCCCCCCCCCCCCCCCCCCCCCCCCCCCCCCC
CCCCCCCCCCCCCCCCCCCCCCCCCCCCCCCCCCCCCCCCCCCCCCCCCCCCCCCCCCCCCCCCCCCCCCCCCCCCCCCCCCCCCCCCCCCCCCC                              CCCCCCCCCCCCCCCCCCCCCCCCCCCCCCCCCCCCCCCCCCCCCCCCCCCCCCCCCCCCCCCCCCCCCCCCCCC
CTCCCCCCCCCCCCCCCCCCCCCCCCCCCCCCCCCCCCCCCCCCCCCCCCCCCCCCCCCCCCCCCCCCCCCCCCCCCCCCCCCCCCCCCCCCCCC                              CCCCCCCCCCCCCCCCCCCCCCCCCCCCCCCCCCCCCCCCCCCCCCCCCCCCCCCCCCCCCCCCCCCCCCCTCCC
CCCCC                                                                                                                                                                                              CCCCC
CCCCC                                                                                                                                                                                              CCCCC
TCCCC                                                                                                                                                                                              TCCCC
CCCCC                                                                                                                                                                                              CCCCC
CCCCC                                                                                                                                                                                              CCCCC
CTCCC                                                                                                                                                                                              CTCCC
CCCCC                                                                                                                                                                                              CCCCC
CCCCC                                                                                                                                                                                              CCCCC
TCCCC                                  HCCCCCCCCCCCCCCCCCCCCCCCCCCCCC                                                                    HCCCCCCCCCCCCCCCCCCCCCCCCCCCCC                            TCCCC
CCCCC                                  CCCCCCCCCCCCCCCCCCCCCCCCCCCCCC                                                                    CCCCCCCCCCCCCCCCCCCCCCCCCCCCCC                            CCCCC
CCCCC                                  CCCCCCCCCCCCCCCCCCCCCCCCCCCCCC                                                                    CCCCCCCCCCCCCCCCCCCCCCCCCCCCCC                            CCCCC
CTCCC                                 CCCCCCCCCCCCCCCCCCCCCCCCCCCCCC                                                                     CCCCCCCCCCCCCCCCCCCCCCCCCCCCCC                            CTCCC
CCCCC                                 CCCCCCCCCCCCCCCCCCCCCCCCCCCCCC                                                                     CCCCCCCCCCCCCCCCCCCCCCCCCCCCCC                            CCCCC
CCCCC                                  CCCCCCCCCCCCCCCCCCCCCCCCCCCCCC                                                                    CCCCCCCCCCCCCCCCCCCCCCCCCCCCCC                            CCCCC
TCCCC                                 CCCCCCCCCCCCCCCCCCCCCCCCCCCCCC                                                                     CCCCCCCCCCCCCCCCCCCCCCCCCCCCCC                            TCCCC
CCCCC                                  CCCCCCCCCCCCCCCCCCCCCCCCCCCCCC                                                                    CCCCCCCCCCCCCCCCCCCCCCCCCCCCCC                            CCCCC
CCCCC                                                                                                                                                                                              CCCCC
CTCCC                                                                                                                                                                                              CTCCC
CCCCC                                                                                                                                                                                              CCCCC
CCCCC                                                                                                                                                                                              CCCCC
TCCCC                                                                                                                                                                                              TCCCC
CCCCC                                                                                                                                                                                              CCCCC
CCCCC                                                                                                                                                                                              CCCCC
CTCCC                                                                                                                                                                                              CTCCC
CCCCC                                                                                                                                                                                              CCCCC
CCCCC                                                                                                                                                                                              CCCCC
TCCCC                                                                                                                                                                                              TCCCC
CCCCC                                                                                                                                                                                              CCCCC
CCCCC                                                                                                                                                                                              CCCCC
CTCCC                                                                                                                                                                                              CTCCC
CCCCC                                                                                                                                                                                              CCCCC
CCCCC                                                                                                                                                                                              CCCCC
TCCCC                                                                                                                                                                                              TCCCC
CCCCC                                                                                                                                                                                              CCCCC
CCCCC                                                                                                                                                                                              CCCCC
CTCCC                                                                                                                                                                                              CTCCC
CCCCC                                                  WWWWWWWWWWWWWWWWWWWWWWWWWWWWWW                                                                                                              CCCCC
CCCCC                                                  WWWWWWWWWWWWWWWWWWWWWWWWWWWWWW                                                                                                              CCCCC
TCCCC                                                  WWWWWWWWWWWWWWWWWWWWWWWWWWWWWW                                                                                                              TCCCC
CCCCC                                                  WWWWWWWWWWWWWWWWWWWWWWWWWWWWWW                                                                                                              CCCCC
CCCCC                                                  WWWWWWWWWWWWWWWWWWWWWWWWWWWWWW                                                                                                              CCCCC
CTCCC                                                  WWWWWWWWWWWWWWWWWWWWWWWWWWWWWW                                                                                                              CTCCC
CCCCC                                                  WWWWWWWWWWWWWWWWWWWWWWWWWWWWWW                                                                                                              CCCCC
CCCCC                                                  WWWWWWWWWWWWWWWWWWWWWWWWWWWWWW                                                                                                              CCCCC
TCCCCTCCCCTCCCCTCCCCTCCCCTCCCCTCCCCTCCCCTCCCCTCCCCTCCCCWWWWWWWWWWWWWWWWWWWWWWWWWWWWWWTCCCCTCCCCTCCCCTCCCCTCCCCTCCCCTCCCCTCCCCTCCCCTCCCCTCCCCTCCCCTCCCCTCCCCTCCCCTCCCCTCCCCTCCCCTCCCCTCCCCTCCCCTCCCCTCCCC
CCCCCCCCCCCCCCCCCCCCCCCCCCCCCCCCCCCCCCCCCCCCCCCCCCCCCCCWWWWWWWWWWWWWWWWWWWWWWWWWWWWWWCCCCCCCCCCCCCCCCCCCCCCCCCCCCCCCCCCCCCCCCCCCCCCCCCCCCCCCCCCCCCCCCCCCCCCCCCCCCCCCCCCCCCCCCCCCCCCCCCCCCCCCCCCCCCCCCCCC
CCCCCCCCCCCCCCCCCCCCCCCCCCCCCCCCCCCCCCCCCCCCCCCCCCCCCCCWWWWWWWWWWWWWWWWWWWWWWWWWWWWWWCCCCCCCCCCCCCCCCCCCCCCCCCCCCCCCCCCCCCCCCCCCCCCCCCCCCCCCCCCCCCCCCCCCCCCCCCCCCCCCCCCCCCCCCCCCCCCCCCCCCCCCCCCCCCCCCCCC
CCCCCCCCCCCCCCCCCCCCCCCCCCCCCCCCCCCCCCCCCCCCCCCCCCCCCCCWWWWWWWWWWWWWWWWWWWWWWWWWWWWWWCCCCCCCCCCCCCCCCCCCCCCCCCCCCCCCCCCCCCCCCCCCCCCCCCCCCCCCCCCCCCCCCCCCCCCCCCCCCCCCCCCCCCCCCCCCCCCCCCCCCCCCCCCCCCCCCCCC