TCCCCTCCCCTCCCCTCCCCTCCCCTCCCCTCCCCTCCCCTCCCCTCCCCTCCCCTCCCCTCCCCTCCCCTCCCCTCCCCTCCCCTCCCCTCCCC                              TCCCCTCCCCTCCCCTCCCCTCCCCTCCCCTCCCCTCCCCTCCCCTCCCCTCCCCTCCCCTCCCCTCCCCTCCCC
CCCCCCCCCCCCCCCCCCCCCCCCCCCCCCCCCCCCCCCCCCCCCCCCCCCCCCCCCCCCCCCCCCCCCCCCCCCCCCCCCCCCCCCCCCCCCCC                              CCCCCCCCCCCCCCCCCCCCCCCCCCCCCCCCCCCCCCCCCCCCCCCCCCCCCCCCCCCCCCCCCCCCCCCCCCC
CCCCCCCCCCCCCCCCCCCCCCCCCCCCCCCCCCCCCCCCCCCCCCCCCCCCCCCCCCCCCCCCCCCCCCCCCCCCCCCCCCCCCCCCCCCCCCC                              CCCCCCCCCCCCCCCCCCCCCCCCCCCCCCCCCCCCCCCCCCCCCCCCCCCCCCCCCCCCCCCCCCCCCCCCCCC
CTCCCCCCCCCCCCCCCCCCCCCCCCCCCCCCCCCCCCCCCCCCCCCCCCCCCCCCCCCCCCCCCCCCCCCCCCCCCCCCCCCCCCCCCCCCCCC                              CCCCCCCCCCCCCCCCCCCCCCCCCCCCCCCCCCCCCCCCCCCCCCCCCCCCCCCCCCCCCCCCCCCCCCCTCCC
CCCCC                                                                                                                                                                                              CCCCC
CCCCC                                                                                                                                                                                              CCCCC
TCCCC                                                                                                                                                                                              TCCCC
CCCCC                                                                                                                                                                                              CCCCC
CCCCC                                                                                                                                                                                              CCCCC
CTCCC                                                                                                                                                                                              CTCCC
CCCCC                                                                                                                                                                                              CCCCC
CCCCC                                                                                                                                                                                              CCCCC
TCCCC                                 H                                                                                                          H                                                 TCCCC
CCCCC                                                                                                                                                                                              CCCCC
CCCCC                                                                                                                                                                                              CCCCC
CTCCC                                                                                                                                                                                              CTCCC
CCCCC                                                                                                                                                                                              CCCCC
CCCCC                                                                                                                                                                                              CCCCC
TCCCC                                                                                                                                                                                              TCCCC
CCCCC                                                                                                                                                                                              CCCCC
CCCCC                                                                                                                                                P                                             CCCCC
CTCCC                                                                                                                                                                                              CTCCC
CCCCC                                                                                                                                                                                              CCCCC
CCCCC                                                                                                                                                                                              CCCCC
TCCCC                                                                                                                                                                                              TCCCC
CCCCC                                                                                                                                                                                              CCCCC
CCCCC                                                                                                                                                                                              CCCCC
CTCCC                                                                                                                                                                                              CTCCC
CCCCC                                                                                                                                                                                              CCCCC
CCCCC                                                                                                                                                                                              CCCCC
TCCCC                                                                                                                                                                                              TCCCC
CCCCC                                                                                                                                                                                              CCCCC
CCCCC                                                                                                                                                                                              CCCCC
CTCCC                                                                                                                                           L                                                  CTCCC
CCCCC                                                                                                                                                                                              CCCCC
CCCCC                                                                                                                                                                                              CCCCC
TCCCC                                                                                                                                                                                              TCCCC
CCCCC                                                                                                                                                                                              CCCCC
CCCCC                                                                                                                                                                                              CCCCC
CTCCC                                                                                                                                                                                              CTCCC
CCCCC                                                  WWWWWWWWWWWWWWWWWWWWWWWWWWWWWW                                                                                                              CCCCC
CCCCC                                                  WWWWWWWWWWWWWWWWWWWWWWWWWWWWWW                                                                                                              CCCCC
TCCCC                                                  WWWWWWWWWWWWWWWWWWWWWWWWWWWWWW                                                                                                              TCCCC
CCCCC                                                  WWWWWWWWWWWWWWWWWWWWWWWWWWWWWW                                                                                                              CCCCC
CCCCC                                                  WWWWWWWWWWWWWWWWWWWWWWWWWWWWWW                                                                                                              CCCCC
CTCCC                                                  WWWWWWWWWWWWWWWWWWWWWWWWWWWWWW                                                                                                              CTCCC
CCCCC                                                  WWWWWWWWWWWWWWWWWWWWWWWWWWWWWW                                                                                                              CCCCC
CCCCC                                                  WWWWWWWWWWWWWWWWWWWWWWWWWWWWWW                                                                                                              CCCCC
TCCCCTCCCCTCCCCTCCCCTCCCCTCCCCTCCCCTCCCCTCCCCTCCCCTCCCCWWWWWWWWWWWWWWWWWWWWWWWWWWWWWWTCCCCTCCCCTCCCCTCCCCTCCCCTCCCCTCCCCTCCCCTCCCCTCCCCTCCCCTCCCCTCCCCTCCCCTCCCCTCCCCTCCCCTCCCCTCCCCTCCCCTCCCCTCCCCTCCCC
CCCCCCCCCCCCCCCCCCCCCCCCCCCCCCCCCCCCCCCCCCCCCCCCCCCCCCCWWWWWWWWWWWWWWWWWWWWWWWWWWWWWWCCCCCCCCCCCCCCCCCCCCCCCCCCCCCCCCCCCCCCCCCCCCCCCCCCCCCCCCCCCCCCCCCCCCCCCCCCCCCCCCCCCCCCCCCCCCCCCCCCCCCCCCCCCCCCCCCCC
CCCCCCCCCCCCCCCCCCCCCCCCCCCCCCCCCCCCCCCCCCCCCCCCCCCCCCCWWWWWWWWWWWWWWWWWWWWWWWWWWWWWWCCCCCCCCCCCCCCCCCCCCCCCCCCCCCCCCCCCCCCCCCCCCCCCCCCCCCCCCCCCCCCCCCCCCCCCCCCCCCCCCCCCCCCCCCCCCCCCCCCCCCCCCCCCCCCCCCCC
CCCCCCCCCCCCCCCCCCCCCCCCCCCCCCCCCCCCCCCCCCCCCCCCCCCCCCCWWWWWWWWWWWWWWWWWWWWWWWWWWWWWWCCCCCCCCCCCCCCCCCCCCCCCCCCCCCCCCCCCCCCCCCCCCCCCCCCCCCCCCCCCCCCCCCCCCCCCCCCCCCCCCCCCCCCCCCCCCCCCCCCCCCCCCCCCCCCCCCCC